###############
#             #
#             #
#             #
#    O OOO    #
#    OOOOO    #
#    OOOOO    #
#     XXX     #
#      P      #
#             #
###############
