###############
#O           O#
#             #
#             #
#             #
#             #
#             #
#     XXX     #
#      P      #
#            O#
###############
