###############
#      #      #
#      #      #
#      #      #
#      ###    #
#             #
#             #
#     XXX     #
# X    P      #
#            O#
###############
